10
XXXXXXXXXX
XM   X   X
X XX X X X
X  X X X X
X  X   X X
X XX X X X
X    X X X
XXXXXXXX X
XE       X
XXXXXXXXXX